111111111111111111111111
111111111111111111111111
110000000000000000000011
110000000000000000000011
110000000000001111111111
110000000000000000000011
110000000000000000000011
110000111100000000000011
110000000000000000000011
110000000000000000111111
110000000000000000111111
110000000011111111111111
110000000000000000000011
110000000000000000000011
111111111111111111111111
111111111111111111111111